[
    [P, R, B, G, T, Y, R, G, B, Y, G, T, T, R, P, T, B, G, Y, R, P, B, G, P, R],
    [Y, 5, 1, 0, 0, 0, 0, 0, 2, 4, 4, 4, 4, 4, 4, 4, 4, 4, 4, 4, 2, 0, 0, 0, G],
    [P, 0, 1, 1, 1, 1, 0, 0, 0, 2, 4, 2, 4, 2, 4, 2, 4, 2, 4, 2, 0, 0, 0, 0, B],
    [B, 0, 0, 0, 0, 0, 0, 0, 0, 0, 2, 4, 2, 4, 2, 4, 2, 4, 2, 0, 0, 0, 0, 0, Y],
    [Y, 0, 1, 0, 1, 1, 0, 0, 0, 0, 0, 2, 4, 2, 4, 2, 4, 2, 0, 0, 0, 0, 0, 0, G],
    [T, 0, 1, 0, 0, R, 0, 0, 0, 0, 0, 0, 2, 2, 2, 2, 2, 0, 0, 0, 0, 0, 0, 0, T],
    [R, 1, 1, 0, 0, R, 0, 0, 0, 0, 0, 0, 0, 0, 0, 0, 0, 0, 0, 0, 0, 0, 0, 0, B],
    [T, 0, 1, 0, 0, R, 0, 0, 0, 0, 0, 0, 0, 0, 0, 0, 0, 0, 0, 0, 0, 0, 0, 0, T],
    [P, 1, 0, 0, 0, R, 0, 0, 0, 0, 0, 0, 0, 0, 0, 0, 0, 0, 0, 0, 0, 0, 0, 0, Y],
    [G, 0, 0, 1, 0, 0, B, B, B, B, T, T, T, T, Y, Y, Y, Y, G, 0, 0, 0, 0, 0, P],
    [Y, 0, 0, 0, 0, 0, 0, 0, G, 0, 0, 0, 0, 0, 0, 0, Y, 0, 0, G, 0, 0, 0, 0, G],
    [R, 0, 1, 0, 0, 0, 0, 0, R, 0, 0, 0, 0, 0, 0, 0, P, 0, 0, G, 0, 0, 0, 0, B],
    [P, 0, 0, 0, 0, 0, 0, 0, B, 0, 0, 0, 0, 0, 0, 0, R, 0, 0, 0, 1, 1, 1, 1, G],
    [G, 0, 0, 0, 0, 0, 0, 0, Y, 0, 0, 0, 0, 0, 0, 0, G, 0, 0, 0, 0, 0, 0, 0, B],
    [R, 0, 0, 0, 0, 0, 0, 0, G, 0, 0, 0, 0, 0, 0, 0, Y, 0, 0, 0, 0, 0, 0, 0, Y],
    [T, 1, 0, 0, 0, 0, 0, 0, R, 0, 0, 0, 0, 0, 0, 0, P, 0, 0, 0, 0, 0, 0, 0, T],
    [Y, 0, 0, 0, 0, 0, 0, P, 0, G, B, Y, R, B, G, R, R, 0, 0, 0, 0, 0, 0, 0, P],
    [P, 0, 0, 0, 0, 0, 0, P, 0, 0, 0, R, 0, 0, 0, 0, G, B, R, Y, B, P, B, R, B],
    [G, 0, 0, 0, 0, 0, 0, G, 0, 0, 0, G, 0, 0, 0, 0, 0, 0, 0, 0, 0, 0, 0, 0, B],
    [B, 2, 1, 4, 1, 4, 1, 4, 0, 0, 0, Y, 0, 0, 0, 0, 0, 0, 0, 0, 0, 0, 0, 0, G],
    [Y, 2, 2, 2, 2, 2, 2, 1, R, Y, G, 0, 0, 0, 0, 0, 0, 0, 0, 0, 0, 0, 0, 0, P],
    [R, 2, 2, 2, 2, 2, 2, 4, 0, 0, 0, 0, 0, 0, 0, 0, 0, 0, 0, 0, 0, 0, 0, 0, G],
    [P, 2, 2, 2, 2, 2, 2, 1, 0, 0, 0, 0, 0, 0, 0, 0, 0, 0, 0, 0, 0, 0, 0, 0, R],
    [B, 2, 2, 2, 2, 2, 2, 0, 0, 0, 0, 0, 0, 0, 0, 0, 0, S, 0, 0, 0, 0, 0, 0, Y],
    [R, P, G, Y, T, G, B, P, G, B, R, T, T, P, P, T, P, G, P, Y, B, R, G, B, P]
];
